000100000100000000000100000000000000000000000001000000000	--->	000100000X00000000000100000000000000000000000001000000000
110101010101110111111101111111110111111111111101111111010	--->	110101010X01110111111101111111110111111111111101111111010
000101010100010001000001000000010100000000000000000000010	--->	000101010X00010001000001000000010100000000000000000000010
011111010111011101011111110101110101111111111111110111111	--->	011111010X11011101011111110101110101111111111111110111111
000000010101000100000000000101000100000001000000010100000	--->	000000010X01000100000000000101000100000001000000010100000
111111110101110111111111111101011111111101011111011101110	--->	111111110X01110XXXXXXX11111101011111111101011111011101110
010000000101000100000100010001000100000001000001000001000	--->	010000000X01000X00000X00010001000100000001000001000001000
010111111101011101110101010111110111011111111101111111010	--->	0101111XXX010XXX01110X01010111110111011111111101111111010
010100010100010001000101000100010001010000000101000100010	--->	0101000X01000X0001000X01000100010001010000000101000100010
010101010101110111011111110101011101110111010101110101110	--->	0101010X010XXX0111011XXXXX0101011101110111010101110101110
010001010001000101000000010101000100000100010100000101000	--->	0100010X000X0001010000000X0101000100000100010100000101000
011111011111011101111111010111110111111101111111011101011	--->	0111110XXXXX0111011111110X0111110111111101111111011101011
000001000000010000000100010000000000000100000000010001010	--->	0000010000000100000001000X0000000000000100000000010001010
011101111111110111110101111111111111110111111111110111010	--->	01110111111111011111010XXX1111111111110111111111110111010
010000000101000100010001000001010000010100000001000101000	--->	01000000010100010001000X000001010000010100000001000101000
011111110101011101011111110101010101110111110111011101110	--->	01111111010101110101111XXX0101010101110111110111011101110
000001000001000101010000010100010100000000000100010100000	--->	0000010000010001010100000X0100010100000000000100010100000
011101111101110101011101010111110111111111111101110101111	--->	0111011111011101010111010X0111110111111111111101110101111
000100010001010001010001010000000000000100000001010001000	--->	0001000100010100010100010X0000000000000100000001010001000
110111011101011111010111011111110111110101111111010111010	--->	1101110111010111110101110X1111110111110101111111010111010
010101000100010000010101010000010100010100000001010000010	--->	0101010001000100000101010X0000010100010100000001010000010
010101110111010111110101010111011101011111111101011111110	--->	0101011101110101111101010X0111011101011111111101011111110
010101000100010000000100010100000001000000000101000001000	--->	0101010001000100000001000X0100000001000000000101000001000
010101011111111111111101110111111111111111110101111101011	--->	01010101111111111111110XXX0111111111111111110101111101011
010001000000000100000101000001000000000100000100010001000	--->	01000100000000010000010X000001000000000100000100010001000
011101111111011101110101011101011111010101111111010111110	--->	01110XXXXXXX01110XXX010X011101011111010101111111010111110
000101000001000001010001010001000001010100000001010100010	--->	00010X00000X00000X0X000X010001000001010100000001010100010
010101110111111111011111110111111101011111111101010101010	--->	01010XXX011XXXXXXX0XXXXX110111111101011111111101010101010
010100010000000001000000000100000001000000000100010101000	--->	0101000X0000000001000000000100000001000000000100010101000
010111010111011111011111011101111111111111011111110101111	--->	0101110X0111011111011111011101111111111111011111110101111
010000010001000000010000010101000000000101000000000001000	--->	0100000X0001000000010000010101000000000101000000000001000
011111111111011111110111110101010111110101111111111111110	--->	01111XXX1111011111110XXX110101010111110101111111111111110
010001000001000100000101000001010001000000000001000000000	--->	01000X000001000100000X0X000001010001000000000001000000000
010101110101111101111101011111011101111111111111010111110	--->	01010X11010111110XXXXX0X011111011101111111111111010111110
000101000100000001000101000100000101000000000000010001010	--->	00010X00010000000X00010X000100000101000000000000010001010
111101011111111111010101110111111101011111111111111101010	--->	11110X01111XXXXXXX01010X110111111101011111111111111101010
000101000001010000010001000100000100010000000001010001000	--->	00010X00000X01000001000X000100000100010000000001010001000
011101011101010111011111011101110111010111111101010111011	--->	01110X01110X01011101111X011101110111010111111101010111011
010001010001010101000001010001010001010001000001010100010	--->	01000X01000X01010100000X010001010001010001000001010100010
010111010111010101111101011101011101011101111101010101110	--->	01011X010XXX01010111110X011101011101011101111101010101110
010001010100000001000001000001000001000100000101010100000	--->	01000X010X0000000100000X000001000001000100000101010100000
011101110111111111011111111111011111110111110101010111110	--->	01110X110X111111110XXXXX111111011111110111110101010111110
000101000100000001010000000101000000010000010101010000010	--->	00010X000X000000010X0000000101000000010000010101010000010
010101011101111101010101110101111111011111010101011111010	--->	01010X0XXX011111010X0101110101111111011111010101011111010
010101010000010100010101010000000100010001000100000100010	--->	01010X0X00000101000X0101010000000100010001000100000100010
110111110111010111110101010111110101111101110111110101111	--->	11011XXX01110101111X0101010111110101111101110111110101111
000001000101010100010101000100010101000001000100010101000	--->	0000010001010101000X0101000100010101000001000100010101000
011101011101110101110101011101010101011111011101010101010	--->	01110101110111010XXX0101011101010101011111011101010101010
010001010001000001000101000101010101000000010001010100010	--->	01000101000100000X000101000101010101000000010001010100010
010111010101011111011101111101011101011111110111011111010	--->	01011101010101111X011101111101011101011111110111011111010
010101010101000001000100000001000001000000010001000001010	--->	01010101010100000X000100000001000001000000010001000001010
010101010101111101110111111111111111111111111101111101110	--->	01010101010111110XXX0111111111111111111111111101111101110
010001010100000100010001000000000000000000010001000100010	--->	0100010101000001000X0001000000000000000000010001000100010
011111010111110101111101011111111111111111010111011111010	--->	01111101011XXX010XXX1101011111111111111111010111011111010
010000010001010001000100010001000100000100010100010001010	--->	01000001000X0X000X000100010001000100000100010100010001010
011111110101011111010111110111010101011101110101110101010	--->	01111111010X0XXXXX010111110111010101011101110101110101010
000000000101000000010000000000010001000000000100000100000	--->	00000000010X000000010000000000010001000000000100000100000
