000100000100000000000100000000000000000000000001000000000
110101010101110111111101111111110111111111111101111111010
000101010100010001000001000000010100000000000000000000010
011111010111011101011111110101110101111111111111110111111
000000010101000100000000000101000100000001000000010100000
111111110101110111111111111101011111111101011111011101110
010000000101000100000100010001000100000001000001000001000
010111111101011101110101010111110111011111111101111111010
010100010100010001000101000100010001010000000101000100010
010101010101110111011111110101011101110111010101110101110
010001010001000101000000010101000100000100010100000101000
011111011111011101111111010111110111111101111111011101011
000001000000010000000100010000000000000100000000010001010
011101111111110111110101111111111111110111111111110111010
010000000101000100010001000001010000010100000001000101000
011111110101011101011111110101010101110111110111011101110
000001000001000101010000010100010100000000000100010100000
011101111101110101011101010111110111111111111101110101111
000100010001010001010001010000000000000100000001010001000
110111011101011111010111011111110111110101111111010111010
010101000100010000010101010000010100010100000001010000010
010101110111010111110101010111011101011111111101011111110
010101000100010000000100010100000001000000000101000001000
010101011111111111111101110111111111111111110101111101011
010001000000000100000101000001000000000100000100010001000
011101111111011101110101011101011111010101111111010111110
000101000001000001010001010001000001010100000001010100010
010101110111111111011111110111111101011111111101010101010
010100010000000001000000000100000001000000000100010101000
010111010111011111011111011101111111111111011111110101111
010000010001000000010000010101000000000101000000000001000
011111111111011111110111110101010111110101111111111111110
010001000001000100000101000001010001000000000001000000000
010101110101111101111101011111011101111111111111010111110
000101000100000001000101000100000101000000000000010001010
111101011111111111010101110111111101011111111111111101010
000101000001010000010001000100000100010000000001010001000
011101011101010111011111011101110111010111111101010111011
010001010001010101000001010001010001010001000001010100010
010111010111010101111101011101011101011101111101010101110
010001010100000001000001000001000001000100000101010100000
011101110111111111011111111111011111110111110101010111110
000101000100000001010000000101000000010000010101010000010
010101011101111101010101110101111111011111010101011111010
010101010000010100010101010000000100010001000100000100010
110111110111010111110101010111110101111101110111110101111
000001000101010100010101000100010101000001000100010101000
011101011101110101110101011101010101011111011101010101010
010001010001000001000101000101010101000000010001010100010
010111010101011111011101111101011101011111110111011111010
010101010101000001000100000001000001000000010001000001010
010101010101111101110111111111111111111111111101111101110
010001010100000100010001000000000000000000010001000100010
011111010111110101111101011111111111111111010111011111010
010000010001010001000100010001000100000100010100010001010
011111110101011111010111110111010101011101110101110101010
000000000101000000010000000000010001000000000100000100000