00001000001000001000
00001000001000001010
11111111111000000010
00000100001111111111
00000100000000100000
00001111110011100000
01111000010000111100
11001000010000100100
00001000010100100100
01111011111111100111
01000010000000100000
01000011111111101111
01110000001000111000
00010111000000100000
00010101011110111110
00010100010010100100
01111111110010100111
00000000100010111100
00000000111110100000
00000000000010000000
